userRegister - password, nome, email(username), iseditor

userEdit - operation - passwordchange - email, pwdOld, pwdNew
				editor - yes/no

userLogin - email, password

musicEdit - album, songname

musicRemove - song

albumEdit - artist, albumName, description

albumRemove - album

artistEdit - artistName, description

artistRemove - artist

findMusic - searchString

findAlbum - searchString

findArtist - searchString

GetAlbum - album

GetArtist - artist

writeReview - review(300 characters), score

uploadServer

uploadedSong - filename, song

sharesong - filename, user1, user2, user....

getfile - filename

--

status,
	ok
	error
	logged
	loggedOff

user

musicList - numberItems, nome1, nome2, nome3, bla, bla, bla (nome, artista)

albumList - numberItems, item1, item2, item3, item4, bla, bla, bla (nome, artista, pontuaçãoMédia)

artistList - numberItems, item1, item2, item3, item4, bla, bla, bla (nome)

reviewList - descrição, pontuação

album - nome, artista, descrição, pontuação
	reviewList - descrição, pontuação
	musicList (check if artist needed?)

artist - nome, descrption
	albumList (check if artist needed)

notify - numberitems, notf1, notif2, notif3

uploadaddress - addresstoupload, filename

fileaddress - address, name






